:::::::::::::::::::::::::::::::::::::::::::::::::::::::::::::::::::
::::::::::::''  ''::'      '::::::  `:::::::::::::'.:::::::::::::::
::::::::::' :. :  :         ::::::  :::::::::::.:::':::::::::::::::
:::::::::::  :   :::.       :::::::::::::..::::'     :::: : :::::::
:::::::::    :':  "::'     '"::::::::::::: :'           '' ':::::::
::'        : '   :  ::    .::::::::'    '                        .:
::               :  .:: .::. ::::'                              :::
::. .,.        :::  ':::::::::::.: '                      .:...::::
::::::::.      '     .::::::: '''                         :: :::::.
:::::::::            ':::::::::  '',            '    '   .:::::::::
:::::::::.        :::::::::::: '':,:   '    :         ''' :::::::::
:::::::::::      ::::::::::::'                        :::::::::::::
:: .::::::::.   .:''::::::::    '         ::   :   '::.::::::::::::
::::::::::::::::. '  '::::::.  '  '     :::::.:.:.:.:.:::::::::::::
::::::::::::::::: :     ':::::::::   ' ,:::::::::: : :.:'::::::::::
:::::::::::::::::: '     :::::::::   . :'::::::::::::::' ':::::::::
:::::::::::::::::::''   :::::::::: :' : ,:::::::::::'      ':::::::
::::::::::::::::::'   .::::::::::::  ::::::::::::::::       :::::::
::::::::::::::::::. .::::::::::::::::::::::::::::::::::::.'::::::::
::::::::::::::::::' :::::::::::::::::::::::::::::::::::::::::::::::
:::::::::::::::::::.:::::::::::::::::::::::::::::::::::::::::::::::
